BOARD SIZE: 8x8
#BLACK PIECES: 12
#WHITE PIECES: 12
     A   B   C   D   E   F   G   H
   +---+---+---+---+---+---+---+---+
 1 | . | w | . | w | . | w | . | w |
   +---+---+---+---+---+---+---+---+
 2 | w | . | w | . | w | . | w | . |
   +---+---+---+---+---+---+---+---+
 3 | . | w | . | w | . | w | . | w |
   +---+---+---+---+---+---+---+---+
 4 | . | . | . | . | . | . | . | . |
   +---+---+---+---+---+---+---+---+
 5 | . | . | . | . | . | . | . | . |
   +---+---+---+---+---+---+---+---+
 6 | b | . | b | . | b | . | b | . |
   +---+---+---+---+---+---+---+---+
 7 | . | b | . | b | . | b | . | b |
   +---+---+---+---+---+---+---+---+
 8 | b | . | b | . | b | . | b | . |
   +---+---+---+---+---+---+---+---+
=====================================
BLACK ACTION #1: G6-F5
BOARD COST: 0
     A   B   C   D   E   F   G   H
   +---+---+---+---+---+---+---+---+
 1 | . | w | . | w | . | w | . | w |
   +---+---+---+---+---+---+---+---+
 2 | w | . | w | . | w | . | w | . |
   +---+---+---+---+---+---+---+---+
 3 | . | w | . | w | . | w | . | w |
   +---+---+---+---+---+---+---+---+
 4 | . | . | . | . | . | . | . | . |
   +---+---+---+---+---+---+---+---+
 5 | . | . | . | . | . | b | . | . |
   +---+---+---+---+---+---+---+---+
 6 | b | . | b | . | b | . | . | . |
   +---+---+---+---+---+---+---+---+
 7 | . | b | . | b | . | b | . | b |
   +---+---+---+---+---+---+---+---+
 8 | b | . | b | . | b | . | b | . |
   +---+---+---+---+---+---+---+---+